00000000000000000000000000000000
00000000000000000000000000000000
00000000000000000000000000000000
00000000000000000000000000000000
0000000000000000000000000G0000B0
000000C0C0C0C0C0C00000B00BBBBBBE
00000C0C0C0C0C0CY0000BB0BBC0C0CB
e000BBBBBBBBBBBBBBBBBBBGC0C0C0MB
BBBBBBBBBBBBBBBBBBBBBBBBBBBBBBBB