0000000000000000000000000000000000
0000000000000000000000000000000000
0000000000CC000000000000000000000E
00000000YCCCCCCCCCCCCCBCC00000000B
00000000BBBBB000BBBBBB0000000000BB
e0000C0Y0CCC0000CC00000YCC00000BBB
BBBBBBBBBBBBBBG000M00CBBBBBBBBBBBB
BBBBBBBBBBBBBBBBBBBBBBBBBBBBBBBBBB